NO ./assets/wall/north.xpm
SO ./assets/wall/south.xpm
WE ./assets/wall/west.xpm
EA ./assets/wall/east.xpm
F 100,100,100
C 200,200,200

1111111111111111111
10000000000C0000001
100000C000000000C01
1000C0000N000000001
1000000000000000001
1111111111111111111

