C 124,186,151
F 166,111,102

NO assets/wall/north.xpm
SO assets/wall/south.xpm
WE assets/wall/west.xpm
EA assets/wall/east.xpm

1111111111111111111
100000000D00000N001
1000011111111000001
1000000000000000001
100000000000000C001
1111111111111111111

