NO ./assets/wall/north.xpm
SO ./assets/wall/south.xpm
WE ./assets/wall/west.xpm
EA ./assets/wall/east.xpm
F 40,40,40
C 220,220,220

11111111111111111111111111111
1C0C0C0C100000000000000000001
1011D110101111111111111111001
10100010D01000000000000001001
1010M010101011111111111001001
10D000D010D01000C000M01001001
10111111101010000000001001001
1000000000D01111111D111001001
10000000001000000000000001001
1000N000001111111111111111001
11111111111111111111111111111