NO ./assets/wall/north.xpm
SO ./assets/wall/south.xpm
WE ./assets/wall/west.xpm
EA ./assets/wall/east.xpm
F 50,50,50
C 150,150,150

1111111111111111111111111
1000000010000000000000001
10C000C0D00000C0000000001
1000000010000000000000001
1111D11110000011111111111
1000000000000010000000001
10C01000000000D000N000C01
1000100000000010000000001
1111111111111111111111111

