NO ./assets/wall/north.xpm
SO ./assets/wall/south.xpm
WE ./assets/wall/west.xpm
EA ./assets/wall/east.xpm
F 50,50,50
C 150,150,150

1111111111111111111111111
1000000010000000000000001
10C0M0C0D00000C0000000001
100000001000000000M000001
1111D11110000011111111111
100000000T0000100M0000001
10C0100000M000D000N000C01
1000000010000000000000T01
1111D11110000011111111111
1000000000000010000000001
10C0100B00M000D000N000C01
1000100000000010000000001
1111111111111111111111111

