NO ./assets/wall/north.xpm
SO ./assets/wall/south.xpm
WE ./assets/wall/west.xpm
EA ./assets/wall/east.xpm
F 100,100,100
C 200,200,200

1111111111111111111
100000000D000000001
1000011111111000001
100000000N000000001
100000000000000C001
1111111111111111111

