C 124,186,151
F 166,111,102

NO assets/wall/north.xpm
SO assets/wall/south.xpm
WE assets/wall/west.xpm
EA assets/wall/east.xpm

1111111111111111111
1001001001001001001
1001001001001001001
10010C10010010C1001
1001001000001001001
100000000S000000001
100001111111100C001
11110C0000000001111
1000000101010000001
1111111111111111111

