C 124,186,151
F 166,111,102

NO assets/wall/north.xpm
SO assets/wall/south.xpm
WE assets/wall/west.xpm
EA assets/wall/east.xpm

1111111111111111111111111111111111111111111111111111111111111111111111111111111111111111111111111111
1000000000000000000000000000000000000000000000000000000000000000000000000000000000000000000000000001
1011111111111111111111111111111111111111111111111111111111111111111111111111111111111111111111111101
1010000000000000000000000000000000000000000000000000000000000000000000000000000000000000000000000101
1010111111111111111111111111111111111111111111111111111111111111111111111111111111111111111111100101
1010100000000000000000000000000000000000000000000000000000000000000000000000000000000000000000100101
1010101111111111111111111111111111111111111111111111111111111111111111111111111111111111111110100101
1010101000000000000000000000000000000000000000000000000000000000000000000000000000000000000010100101
1010101011111111111111111111111111111111111111111111111111111111111111111111111111111111111010100101
1010101010000000000000000000000000000000000000000000000000000000000000000000000000000000000010100101
1010101010111111111111111111111111111111111111111111111111111111111111111111111111111111111100100101
1010101010100000000000000000000000000000000000000000000000000000000000000000000000000000000000100101
1010101010101111111111111111111111111111111111111111111111111111111111111111111111111111111110100101
1010101010101000000000000000000000000000000000000000000000000000000000000000000000000000000000100101
1010101010101011111111111111111111111111111111111111111111111111111111111111111111111111111110100101
1010101010101010000000000000000000000000000000000000000000000000000000000000000000000000000000100101
1010101010101010111111111111111111111111111111111111111111111111111111111111111111111111111100100101
1010101010101010100000000000000000000000000000000000000000000000000000000000000000000000000000100101
1010101010101010101111111111111111111111111111111111111111111111111111111111111111111111111110100101
1010101010101010101000000000000000000000000000000000000000000000000000000000000000000000000000100101
1010101010101010101011111111111111111111111111111111111111111111111111111111111111111111111110100101
1010101010101010101010000000000000000000000000000000000000000000000000000000000000000000000000100101
1010101010101010101010111111111111111111111111111111111111111111111111111111111111111111111100100101
1010101010101010101010100000000000000000000000000000000000000000000000000000000000000000000000100101
1010101010101010101010101111111111111111111111111111111111111111111111111111111111111111111110100101
1010101010101010101010101000000000000000000000000000000000000000000000000000000000000000000000100101
1010101010101010101010101011111111111111111111111111111111111111111111111111111111111111111110100101
1010101010101010101010101010000000000000000000000000000000000000000000000000000000000000000000100101
1010101010101010101010101010111111111111111111111111111111111111111111111111111111111111111100100101
1010101010101010101010101010100000000000000000000000000000000000000000000000000000000000000000100101
1010101010101010101010101010101111111111111111111111111111111111111111111111111111111111111110100101
1010101010101010101010101010101000000000000000000000000000000000000000000000000000000000000000100101
1010101010101010101010101010101011111111111111111111111111111111111111111111111111111111111110100101
1010101010101010101010101010101010000000000000000000000000000000000000000000000000000000000000100101
1010101010101010101010101010101010111111111111111111111111111111111111111111111111111111111100100101
1010101010101010101010101010101010100000000000000000000000000000000000000000000000000000000000100101
1010101010101010101010101010101010101111111111111111111111111111111111111111111111111111111110100101
1010101010101010101010101010101010101000000000000000000000000000000000000000000000000000000000100101
1010101010101010101010101010101010101011111111111111111111111111111111111111111111111111111110100101
1010101010101010101010101010101010101010000000000000000000000000000000000000000000000000000000100101
1010101010101010101010101010101010101010111111111111111111111111111111111111111111111111111100100101
1010101010101010101010101010101010101010100000000000000000000000000000000000000000000000000000100101
1010101010101010101010101010101010101010101111111111111111111111111111111111111111111111111110100101
1010101010101010101010101010101010101010101000000000000000000000000000000000000000000000000000100101
1010101010101010101010101010101010101010101011111111111111111111111111111111111111111111111110100101
1010101010101010101010101010101010101010101010000000000000000000000000000000000000000000000000100101
1010101010101010101010101010101010101010101010111111111111111111111111111111111111111111111100100101
1010101010101010101010101010101010101010101010100000000000000000000000000000000000000000000000100101
1010101010101010101010101010101010101010101010101111111111111111111111111111111111111111111110100101
1010101010101010101010101010101010101010101010101000000000000000000000000000000000000000000000100101
1010101010101010101010101010101010101010101010101011111111111111111111111111111111111111111110100101
1010101010101010101010101010101010101010101010101010000000000000000000000000000000000000000000100101
1010101010101010101010101010101010101010101010101010111111111111111111111111111111111111111100100101
1010101010101010101010101010101010101010101010101010100000000000000000000000000000000000000000100101
1010101010101010101010101010101010101010101010101010101111111111111111111111111111111111111110100101
1010101010101010101010101010101010101010101010101010101000000000000000000000000000000000000000100101
1010101010101010101010101010101010101010101010101010101011111111111111111111111111111111111110100101
1010101010101010101010101010101010101010101010101010101010000000000000000000000000000000000000100101
1010101010101010101010101010101010101010101010101010101010C00000000000000000000000000000000000100101
1010101010101010101010101010101010101010101010101010101010000000000000000000000000000000000000100101
1010101010101010101010101010101010101010101010101010101010111111111111111111111111111111111100100101
1010101010101010101010101010101010101010101010101010101010100000000000000000000000000000000000100101
1010101010101010101010101010101010101010101010101010101010101111111111111111111111111111111110100101
1010101010101010101010101010101010101010101010101010101010101000000000000000000000000000000000100101
1010101010101010101010101010101010101010101010101010101010101011111111111111111111111111111110100101
1010000000000000000000000000000000000000000000000000000000000000000000000000000000000000000000000N01
1011111111111111111111111111111111111111111111111111111111111111111111111111111111111111111111111101
1000000000000000000000000000000000000000000000000000000000000000000000000000000000000000000000000001
1111111111111111111111111111111111111111111111111111111111111111111111111111111111111111111111111111
