11111111111111111111111111111111111111111111111111111111111111111111111
10000C00000000000110000000010000000000000010000C00000000000010000000001
10000C00000000000P10000000010000000000000010000100000000000010000000001
10001111000100111110001111110000001111100010000111111111100010000000001
10001111000100000110001000000000001111100010000000000000100010000000001
10000000000100100110001000000000001111100010000000000000100010000000001
10000000000000100110001111111100000000100011111100100000100011111111111
1111111110001111111000CCCC0001000000001000C0000000100000100000010000001
111111111000100000C00011110001000000001000C00000001000001000000C00000R1
10000000000010000010001000000100000000111111111100100000100000010000001
10000000000010000010001000111100000000C00000000100100000111111111111111
10001111111111111110001000100000000000100000000100100000000010000000001
1000C000000000000100001000111111111111111111000100111111110010000000001
10001011100011000100001000000000000000000000000100000000000011111111111
10001000000000000C000010000000000000000000000001000000000000CCCCCCCCCC1
11111111111111111111111111111111111111111111111111111111111111111111111